###################
#........#........#
#.##.###.#.###.##.#
#.................#
#.##.#.#####.#.##.#
#....#...#...#....#
#.##.###.#.###.##.#
#.##.#..+.+..#.##.#
#.##.#.##0##.#.##.#
.......#123#.......
#.##.#.#####.#.##.#
#.##.#.......#.##.#
#.##.###.#.###.##.#
#....#...#...#....#
#.##.#.#####.#.##.#
#.....+..@..+.....#
#.##.###.#.###.##.#
#........#........#
###################