#####
##0##
#123#
#####
..@..
#.#.#
..#..
#####